Фінансові послуги		
ПУМБ	Банк	Рінат Ахметов
Брокбізнесбанк	Банк	Сергій Курченко
Надра Банк	Банк	Фурсін, Фірташ
Правекс-Банк	Банк	Дмитро Фірташ
Форум Банк	Банк	Вадим Новинский
Південкомбанк	Банк	Руслан Циплаков
ТАСкомбанк	Банк	Сергій Тігіпко
Імексбанк	Банк	Леонід Клімов
Всеукраїнський Банк Розвитку	Банк	Олександр Янукович
Фідобанк	Банк	Олександр Адаріч
Терра Банк	Банк	Руслан Циплаков
Реал банк	Банк	Сергій Курченко
Мегабанк	Банк	Віктор Суботін
Ренессанс Кредит	Банк	Рінат Ахметов
ТАС Страхова	Страхові послуги	Сергій Тігіпко
АСКА Страхова	Страхові послуги	Рінат Ахметов
Експрес Страхування	Страхові послуги	Таріел Васадзе
UnexBank	Банк	Вадим Новинский
Банк Перший	Банк	Курченко, Пшонка
БМ Банк	Банк	Вадим Новинский
Місто Банк	Банк	Іван Фурсін
ВУСО	Страхові послуги	Руслан Циплаков
Dominanta	Страхові послуги	Олександр Янукович
Гарантія	Страхові послуги	Руслан Циплаков
Іллічівське	Страхові послуги	Рінат Ахметов
		
Продукти харчування		
Галичина	Молочна продукція	Єремеєв/Івахів
Комо	Сири	Єремеєв/Івахів
Клуб Сиру	Сири	Єремеєв/Івахів
Конті	Суперконтік, Bonjour, Esfero, Amour, Беллиссимо	Борис Колєсніков
Верес	Консервація, соуси	Вадим Новинский
Гаврилівські курчата	Куряче м'ясо	Евгений Сигал
Артемівське шампанське	Алкоголь	Олександр Янукович
Новый свет	Алкоголь	Янина Павленко
Батік	Чай	Віктор Пилипишин
Аскольд	Чай	Віктор Пилипишин
Волошкове поле	Молочна продукція	Олександр Табалов
Prime	Алкоголь (холдинг Олімп)	Павло Климець
Приватна колекція	Алкоголь (холдинг Олімп)	Павло Климець
Марсель	Алкоголь (холдинг Олімп)	Павло Климець
Бахчисарай	Алкоголь (холдинг Олімп)	Павло Климець
Плакучая Ива	Алкоголь (холдинг Олімп)	Павло Климець
Фляжка	Алкоголь (холдинг Олімп)	Павло Климець
Істинна	Алкоголь (холдинг Олімп)	Павло Климець
Три ведмеді	Морозиво та холодопродукти	Дмитро Ушмаєв
Росинка	Безалкогольні напої	Руслан Лебеденко
Софія Київська	Вода газована	Руслан Лебеденко
Закарпатський, Тиса	Кон'як	Володимир Гісем
Щирий кум	Ковбасна і м'ясна продукція	Акневский Юрий
Ласка, ЩедроВ	Морозиво та холодопродукти	Костянтин Чередник
Від доброї курки	Куряче м'ясо	сім'я Ярошенко
Славія	Олія	Остроушко Валерій
Родинна ковбаска	Ковбасна і м'ясна продукція	Баран Олег
Пан Курчак	Ковбасна і м'ясна продукція	Сергій Мартиняк
Холодний Яр	Алкоголь	Вадим Льошенко
Курка Чеботурка	Куряче м'ясо	Михайло Добкін
Білозгар	Сири	Петро Тихонюк
Первомайський молочноконсервний комбінат	Молочні вироби	Олександр Табалов
Добра кава	Кава	Віктор Пилипишин
Вершковий рай	Сири	Табалови
Королевське	Морозиво	Наталя Королевська
Сонола	Олія, масло та маргарин	Станіслав Березкін
Кум	Олія, масло та маргарин	Станіслав Березкін
Деликон	Олія, масло та маргарин	Станіслав Березкін
Масловия	Олія, масло та маргарин	Станіслав Березкін

Торгівля		
Амстор	Мережа супермаркетів	Вадим Новинский
Брусничка	Мережа супермаркетів	Рінат Ахметов
Епіцентр К	Мережа будівельних магазинів	Герега Галина/Олександр
Нова Лінія	Мережа будівельних магазинів.	Герега Галина/Олександр
М'ясна весна	Мережа магазинів	Борис Колесніков
М'ясна точка	Мережа магазинів	Сергій Мартиняк
topmall.ua	Інтернет магазини	Вікторія Тігіпко

Медицина		
Стиролбиофарм	Фармацевтика. Препараты стирола	Дмитро Фірташ
Аптека ТАС	Мережі аптек	Сергій Тигипко
Наша аптека	Мережа аптек	Володимир Дудка
Біофарма	Фармацевтика	Василь Хмельницкий

Телекомунікаційні послуги		
Укртелеком, ОГО	Фіксований звязок, інтернет-провайдер	Рінат Ахметов
Life	Мобільний оператор (43%)	Рінат Ахметов
Vega	Інтернет-провайдер	Рінат Ахметов
3mob	ПАТ "УкрТелеКом"	Рінат Ахметов
Triolan	Випадки блокування ТВi	Генадій Кернес

Мережі заправних станцій		
WOG	Мережа заправних станцій	Єремеєв/Івахів
Параллель	Мережа заправних станцій	Рінат Ахметов
БРСМ Нафта	Мережа заправних станцій	Эдуард Ставицкий
УкрАвто АЗК	Мережа заправних станцій	Таріел Васадзе
Газовик	Мережа заправних станцій	Вячеслав Кутовий

Товари для дому		
Nord	побутова техніка	Валентин Ландык
Swizer	побутова техніка	Валентин Ландык
Зебра, TRIORA, Мальва	фарби фірми ЗІП	Олег Захорольський
Обуховський туалетний папір, Диво, Soffione	Туалетний папір та паперові рушники	Володимир Крупчак
Фрекен Бок, Бонус	товари для прибирання	Андрій Здесенко

Преса		
Сегодня	газета	Рінат Ахметов
Вести	бесплатная газета	Віктор Медведчук
Кореспондент	Журнал	Сергій Курченко
Комсомольськая правда	Газета	Сергій Курченко
Аргументы и факты	Газета	Сергій Курченко
Теленеделя	Журнал	Сергій Курченко
Футбол	Журнал	Сергій Курченко
Комментарі	Журнал	Сергій Курченко
Forbes	Журнал	Сергій Курченко
Vogue	Журнал	Сергій Курченко
Kyiv Weekly	Журнал	Сергій Курченко
Капітал	Газета	Сергій Арбузов
Взгляд	Газета	Сергій Арбузов

Інтернет		
tochka.net, i.ua, bigmir.net.	портали	Сергій Курченко
korrespondent.net	Сайт	Сергій Курченко
Forbes.ua	Сайт	Сергій Курченко
Football.ua	Сайт	Сергій Курченко
Isport.ua	Сайт	Сергій Курченко
ugmk.info	сайт	Сергій Курченко
comments.ua	сайт	Сергій Курченко
vesti.ua	сайт	Віктор Медведчук

Радіо		
Русское Радио Украина	Радіостанція	Микола Баграєв
Хит ФМ	Радіостанція	Микола Баграєв
Ретро ФМ	Радіостанція	Сергій Курченко
Кисс ФМ	Радіостанція	Микола Баграєв
Авторадіо	Радіостанція	Сергій Курченко
Радио Рокс	Радіостанція	Микола Баграєв
Наше радіо	Радіостанція	Сергій Курченко
Мелодия	Радіостанція	Микола Баграєв
Європа+ 92,8FM	Радіостанція (Не плутати з 107FM)	Сергій Курченко
Ера ФМ	Радіостанція	Андрій Деркач
Джем ФМ	Радіостанція	Сергій Курченко
Лаунж ФМ	Радіостанція	Сергій Курченко
Голос Столиці	Радіостанція	Сергій Курченко
Super radio	Радіостанція	Сергій Курченко

Телебачення		
Інтер	телеканал	Дмитро Фірташ
Україна	телеканал	Рінат Ахметов
К1, К2	телеканал	Дмитро Фірташ
Мега	телеканал	Дмитро Фірташ
Ентер фільм	телеканал	Дмитро Фірташ
Тоніс	телеканал	Сергій Арбузов
112-Україна	телеканал	Сергій Арбузов
НЛО ТВ	телеканал	Рінат Ахметов
БТБ	телеканал	Сергій Арбузов
Футбол і Футбол+	телеканал	Рінат Ахметов
XSport	телеканал	Борис Колесніков
Т2	Цифрове телебачення	Ахметов/Хорошковський
Oll.tv	Цифрове телебачення	Рінат Ахметов

Інформагентсва		
PHL	Фотоінформаційне агентсво	Сергій Курченко
golos.ua	Информагентство	Оксана Ващенко

Транспорт		
АІС	Дистрибутор GEELY, Ssang Yong, ГАЗ, Citroen, Renault, Audi, Chevrolet. Магазини запчастин, мережа автосалонів, сто.	Святаш и Поляков
УкрАвто	Виробник автомобілів Lanos, дистрибутор Maserati, Mercedez, Jeep, Chrysler, Opel, Chevrolet, KIA, Chevrolet, Renault, Chery, Lada, Toyota, Nissan, Lada	Таріел Васадзе
ARMA MOTORS	Диллер Renault	Олександр Сивкович
		
Спорт та розваги		
Михайло Поплавський	концертная деятельность	
Таісія Повалий	концертная деятельность	
Володимир Гришко	концертная деятельность	
Ян Табачник	концертная деятельность	
Наталія Могилевська	концертная деятельность	
Марія Яремчук	співачка, Учасник Євробачення	
БК Киев	Баскетбольний клуб	Александр Волков
ФК Шахтар Донецьк	Футбольний клуб	Рінат Ахметов
ФК Говерла Закарпаття	Футбольний клуб	Нестор Шуфрич
ФК Севастополь	Футбольний клуб	Вадим Новінський
ФК Металіст Харків	Футбольний клуб	Сергій Курченко
ФК Металург Запоріжжня	Футбольний клуб	Олександр Богуслаєв
ФК Чорноморець Одеса	Футбольний клуб	Леонід Клімов
ФК Зоря Луганськ	Футбольний клуб	Євген Геллер
ФК Іллічівець Маріуполь	Футбольний клуб	Бойко\Ахметов

Київ					
Київхліб	Хлібобулочна продукція	Атрошенко Владислав			
Кулиничі	Хлібобулочна продукція	Мисик Володимир			
Квадрат на Дружби Народів	Торговий центр	Оксана Калетник			
Квадрат на Гната Юри	Торговий центр	Оксана Калетник			
Ринок Столичний на Окружній	Сільско-господарський ринок	Юрій Іванющенк			
КредитМаркет	банківськи послуги	Сергій Тигіпко			
ARGO	мережа магазинів одягу http://argo.com.ua/	Володимир Дейнега			
ЛІВС	меблі	Любов Савченко			
Украфлора	Квіти	Віктор Пилипишин			
Егоїст (Київ)	Ресторан	Анатолій Голубченко			
О'Панас (Київ)	Ресторан	Оксана Калетник			
Mai Tai Lounge (Київ)	Ресторан	Оксана Калетник			
Опера (Київ)	Ресторан	Рінат Ахметов			
Первак (Київ)	Ресторан	Таріел Васадзе			
Трипілля (с. Підгірці)	Ресторанно-готельний комплекс	Оксана Калетник			
Arena City (Київ)	ТРЦ	Дмитро Фірташ			
Бабай	Ресторан	брати Мазепи			
Козак-холл	Ресторан	Михайло Поплавський			
Батьківська Хата	Ресторан на трасі Київ-Одеса	Михайло Поплавський			
Вареники	Ресторан на трасі Київ-Одеса	Михайло Поплавський			
Сонячна долина	Котеджне містечко	Сергей Тигипко			
DarwinPlaza	Офісна будівля	Александр Фельдман			
БЦ "Парус"	Офісна будівля	Дмитро Фірташ			
Новопечерские Липки	Житлові комплекси UDP	Василь Хмельницкий			
Паркове місто	Житлові комплекси UDP	Василь Хмельницкий			
Бульвар фонтанов	Житлові комплекси UDP	Василь Хмельницкий			
River Stone	Житлові комплекси UDP	Василь Хмельницкий			
Паркові озера	Забудовник “Інтергал-Буд”	Володимир Зубик			
Малахіт	Забудовник “Інтергал-Буд”	Володимир Зубик			
Яскравий	Забудовник “Інтергал-Буд”	Володимир Зубик			
Лідер	Забудовник “Інтергал-Буд”	Володимир Зубик			
Познякижилбуд	Забудовник, Київ	Нвєр Мхітарян			
Ліко-Град, Венеція	Житлові комплекси від "Ліко-Холдінг"	Ігор Лисов			
					
Одеса					
Новый привоз	Торговий центр в Одессі	Леонід Клімов			
ЦУМ Одеса	Торговий центр в Одессі	Леонід Клімов			
Рыбный корпус	Торговий центр в Одессі	Леонід Клімов			
Александровский	Торговий центр в Одессі	Леонід Клімов			
Малиновский ТЦ	Торговий центр в Одессі	Леонід Клімов			
Седьмой километр	Крупнейший рынок г. Одесса	Юрій Иванющенко			
Чорне море	Мережа готелів Одеса, Київ	Леонід Клімов			
Батьківська Хата	Ресторан на трасі Київ-Одеса	Михайло Поплавський			
Вареники	Ресторан на трасі Київ-Одеса	Михайло Поплавський			
Деловая Одесса	Газета, інтерент-портал	Леонід Клімов			
Медиа-информ	Телеканал	Леонід Клімов			
eho-ua	Інтерент-сайт	Леонід Клімов			
Глас	Телеканал	Геннадій Труханов			
Maristella	Житлові комплекси UDP	Василь Хмельницкий			
Арианда	Котеджный поселок	Геннадій Труханов			
Ark Place	Жилой комплекс	Геннадій Труханов			
Академия	Телеканал	Сергій Ківалов			
					
Дніпропетровськ					
Le Grand	Ресторани	Ступак Іван			
Кокос	Ресторани	Ступак Іван			
Какао	Ресторани	Ступак Іван			
Кабаре	Ресторани	Ступак Іван			
ТОВ "Машиностроитель"	Будівництво	Михайло Кремена			
Днепропетровская бумажная фабрика	Бумажная продукция	Олег Царьов			
Семейка	Сеть супермаркетов	Олександр Вілкул			
Рубин	Ювелирный дом	Олександр Вілкул			
Дніпропетровський хлібокомбінат №2	Хлібобулочні вироби	Олег Царьов			
Новомосковський комбінат хлібопродуктів	Хлібобулочні вироби	Олег Царьов			
34	телеканал	Рінат Ахметов			
					
Донецьк					
УкрБизнесБанк	Банк	Олександр Янукович			
Белый лебедь	Торгiвельний центр	Борис Колесников			
Станица	Молочна продукція	Олександр Єфремов			
Сарепта	Мережа аптек	Олександр Лук'янченко			
Илиташ тур	Туристичні послуги	Игор Шкиря			
UKRBUS	Пасажирські перевезення	Игор Шкиря			
Перший діловий	Телеканал	Игор Шкиря			
ura-inform.com	Інтерент видання	Игор Шкиря			
Донецкие новости	Газета	Рінат Ахметов			
Вечерний Донецк	Газета	Рінат Ахметов			
Приазовский рабочий	Газета	Рінат Ахметов			
Донбасс	Телеканали	Рінат Ахметов			
Сигма ТВ	Телеканали	Рінат Ахметов			
Сфера ТВ	Телеканали	Рінат Ахметов			
Страховые гарантии	Страхова компанія	Олександр Янукович			
					
Луганськ					
ТМ Станица	Молочна продукція	Олександр Єфремов			
Семейный	Сеть супермаркетов	Ростислав Руль			
Лелека	Сеть супермаркетов	Ростислав Руль			
Абсолют	Сеть супермаркетов	Леонид Фесенко			
Укркоммунбанк	Банк	Едуард Лозовский			
Пінта	Ресторан	Володимир Струк			
Детский Мир	ТЦ	Володимир Ландик			
Россия	ТЦ	Володимир Медяник			
ЛуганскСитиЦентр	ТЦ	Володимир Медяник			
J.Casanova	Ресторан	Володимир Медяник			
Portofino	Ресторан в Алчевську	Костянтин Петров			
Восточные ресурсы	Мережа автозаправок	Володимир Шостак			
Луганское кабельное телевидение	Провайдер кабельного ТБ	Герман Кудинов			
Оранта-Лугань	Страховая компнаия	Едуард Лозовский			
Спутник-Луганск	Туристичні послуги	Владим3ир Пристюк			
PartyZone	Развлекательный комплекс, кейтеринг	Костянтин Петров			
cxid.info	Інформаційне агентсво	Едуард Лозовский			
ИРТА	телерадіокомпанія, інформ-агентсто	Володимир Ландик			
Европа Плюс Луганск 104.	радіо	Володимир Ландик			
Неделя	Медіа група	Костянтин Петров			
Вечерний луганск	газета	Володимир Ландик			
Термо	Газовые котлы и котельни	Едуард Лозовський			
Маршал	Машиностроение	Сергій Горохов			
					
Харків					
Барабашово	Торговий-центр (ринок)	Олександр Фельдман			
Кулиничі	Хлібобулочна продукція	Володимир Мисик			
Райский уголок	книжный рынок, ресторан	Володимир Полозков			
Мегабанк	Банк	Віктор Суботін			
Золоті ворота	Банк	Михайло Добкін			
Дом быта "Центральный"	Дом быта	Геннадій Кернес			
Сатек	Cеть химчисток	Геннадій Кернес			
Националь	Казино и гостиница	Геннадій Кернес			
Авантаж	Будівельна компанія	Анатолій Денисенко			
КлубНичка	Развлекательний комплекс	Ігор Потапов			
Хладик	Мороженное	Алексей Барышевский			
Вечерний Харьков	Газета	Геннадій Кернес			
7-й канал	Телеканал	Геннадій Кернес			
Пробка	Пиво	Михайло Добкін			
Белый колодец	сахар	Михайло Добкін			
Здоров’Я	Мережа аптек	Алексей Брунь			
Телесенс	Бізнес Центр	Габріел Михайлов			
					
Львів					
Ринок "Південний"	Торгово-виробничий комплекс	Петро Писарчук			
ОКСІ Банк	Банк	Олег Баляш			
ШОК	Магазини електротехніки	Олег Баляш			
Крез	Магазини електротехніки	Олег Баляш			
Золота форель	Відпочинковий комплекс	Олег Сало			
Інтергал-Буд	Будівелька компанія	Володимир Зубик			
Родинна кондитерська	Кондитерські вироби	Баран Олег			
					
Черкаси					
Формула смаку	Хлібобулочна, кондитерська продукція	Табалови			
Королівське борошно	Хлібобулочна продукція	Олександр Коротков			
					
Полтава					
Гадячсир	Сири	Руслан Бадаєв			
Рідне село	Магазини	Тетяна Корост			
Маяківська свіжина	Ковбаса	Тетяна Корост			
					
Херсон					
Fabrika	ТРЦ	Олександр Янукович			
БЕБКО Финанс	Кредитный союз	Бебко Иван			
БЕБКО-Авто	Автосалон	Бебко Иван			
					
Закарпаття					
tyachivnews.in.ua	Інформаційне агентство в Тячеві	Олег Палінкаш			
Позитив	Рекламне агентсво і вуличне радіо в Тячеві	Олег Палінкаш			
Династія	Меблева фабрика в Тячеві	Олег Палінкаш			
Меліта	ТЦ в Тячеві	Михайло Цірик			
					
Миколаїв					
Зелений Гай	Алкоголь	Ігор Дятлов			
Формула смаку	Хлібобулочна, кондитерська продукція	Табалови			
					
Івано-Франківськ					
Ласощі	Кондитерські вироби	Юрій Калестин			
Захід	Телеканал	Юрій Калестин			
					
Вінниця					
Варшава	Мережа супермаркетів	Наталія Гетце			
ВАТ «Вінницямолоко»		Володимир Продивус			
ВАТ «Муровано-Куриловецький завод мінеральної води „Регіна“		Володимир Продивус			
ЗАТ «Вінницький універмаг»		Володимир Продивус			
ВАТ «Вінницяфармація»		Володимир Продивус			
Бажаємо здоров`я	Мережа аптек	Володимир Продивус			
					
Хмельницький					
Деражнянський молокозавод		Валерій Яглінський			
Ринок "Кооператор"		Микола Ворона			
Вікно Плюс	Виробник вікон	Сергій Ведерніков			
Ясен	Меблі	Анатолій Демид			
Мегаполіс	Магазин будматеріалів	Микола Дерикот			
ТРЦ Либідь-Плаза	ТРЦ	Кольгофер			
Деражнянський молочний завод	Молочні продукти	Валерій Яглінський			
					
Крим					
Санаторий имени Кирова		Олег Царев			
Комплекс «Судак»		Вадим Новинский			
Аквапарк Судак, Водный Мир		Борис Дейч			
					
Чернігів					
Ічня	Молочні продукти	Валентин Запорощук			
Куликівське молоко	Молочні продукти	Арсен Дідур			
Проун	Меблі	Михайло Півень			
Ратибор II	М'ясні вироби	Віктор Труш	